NO textures/glass.png
SO textures/glass.png
WE textures/glass.png
EA textures/glass.png


F 104,183,144
C 104,133,144


11111111111111111111111111
100000E0000000000000000001
1               1111111111111
11111100000000000000000000001
     111                    1 
       1101111111111111111111
        10000000000000000000111
        10000000000000000000001
        11111111111111111111111   